sMapName,TestMap
iLayerCount,2
mTexPath,RES\image\tilesets\mansion.png
mTexDataPath,RES\data\map_tile_mansion.txt
mTexSplitX,8
mTexSplitY,16
iTileCount,128
mapWidth,60
mapHeight,40
bBeginReadMP,True
6,6,6,6,6,6,6,6,6,6,6,6,6,6,6,6,6,6,6,6,6,6,6,6,6,6,6,6,6,6,6,6,6,6,6,6,6,6,6,6,6,6,6,6,6,6,6,6,6,6,6,6,6,6,6,6,6,6,6,6,
6,6,6,6,6,6,6,6,6,6,6,6,6,6,6,6,6,6,6,6,6,6,6,6,6,6,6,6,6,6,6,6,6,6,6,6,6,6,6,6,6,6,6,6,6,6,6,6,6,6,6,6,6,6,6,6,6,6,6,6,
6,6,8,9,9,9,9,9,9,9,9,9,9,9,9,9,9,9,9,9,9,9,10,6,6,8,9,9,9,9,9,9,9,9,9,9,9,9,9,9,9,9,9,9,9,9,10,6,6,8,9,9,9,9,9,9,9,10,6,6,
6,6,16,17,17,17,17,17,17,17,17,17,17,17,17,17,17,17,17,17,17,17,18,6,6,16,17,17,17,17,17,17,17,17,17,17,17,17,17,17,17,17,17,17,17,17,18,6,6,16,17,17,17,17,17,17,17,18,6,6,
6,6,24,25,25,25,25,25,25,25,25,25,25,25,25,25,25,25,25,25,25,25,26,6,6,24,25,25,25,25,25,25,25,25,25,25,25,25,25,25,25,25,25,25,25,25,26,6,6,24,25,25,25,25,25,25,25,26,6,6,
6,6,3,3,3,3,3,3,3,3,3,3,2,2,2,2,2,2,2,2,2,2,2,6,6,2,2,6,6,2,2,2,3,3,3,3,3,3,3,3,3,3,3,3,3,3,3,6,6,3,3,3,3,3,3,3,3,3,6,6,
6,6,3,5,5,3,3,3,3,3,3,3,2,2,5,5,5,5,5,5,5,2,2,6,6,2,2,6,6,2,2,2,3,3,3,3,3,3,3,3,3,3,3,3,3,3,3,6,6,3,3,3,3,3,3,3,3,3,6,6,
6,6,3,5,5,3,3,3,3,3,6,6,2,2,5,5,5,5,5,5,5,2,2,6,6,2,2,8,10,2,2,2,3,3,3,3,3,3,3,3,3,5,5,5,5,5,3,6,6,3,5,5,5,5,5,3,3,3,6,6,
6,6,3,3,3,3,3,3,3,3,6,6,2,2,2,2,2,2,2,2,2,2,2,6,6,2,2,16,18,2,2,2,6,6,3,3,3,3,3,3,3,5,5,5,5,5,3,6,6,3,5,5,5,5,5,3,3,3,6,6,
6,6,3,3,3,3,3,3,3,3,6,6,2,2,2,2,2,2,2,2,2,2,2,6,6,2,2,24,26,2,2,2,6,6,3,3,3,3,3,3,3,5,5,5,5,5,3,6,6,3,5,5,5,5,5,3,3,3,6,6,
6,6,3,3,3,3,3,3,3,3,6,6,2,2,2,2,2,2,2,2,2,2,2,6,6,2,2,2,2,2,2,2,6,6,3,3,3,3,3,3,3,3,3,3,3,3,3,6,6,3,3,3,3,3,3,3,3,3,6,6,
6,6,3,3,3,3,3,3,3,3,6,6,2,2,2,2,2,2,2,2,2,2,2,6,6,2,2,2,2,2,2,2,6,6,3,3,3,3,3,3,3,3,3,3,3,3,3,6,6,3,3,3,3,3,3,3,3,3,6,6,
6,6,6,6,6,6,6,6,6,6,6,6,6,2,2,6,6,6,6,6,6,6,6,6,6,6,6,6,2,2,2,6,6,6,6,6,6,6,6,6,6,6,6,6,6,6,6,6,6,6,6,6,3,3,3,6,6,6,6,6,
6,6,6,6,6,6,6,6,6,6,6,6,6,2,2,6,6,6,6,6,6,6,6,6,6,6,6,6,2,2,2,6,6,6,6,6,6,6,6,6,6,6,6,6,6,6,6,6,6,6,6,6,3,3,3,6,6,6,6,6,
6,6,8,9,9,9,9,9,9,9,9,9,10,2,2,8,9,9,9,9,9,9,9,9,9,9,9,10,2,2,2,8,9,9,9,9,9,9,9,9,9,9,9,9,9,9,9,9,9,9,9,10,3,3,3,8,9,10,6,6,
6,6,16,17,17,17,17,17,17,17,17,17,18,2,2,16,17,17,17,17,17,17,17,17,17,17,17,18,2,2,2,16,17,17,17,17,17,17,17,17,17,17,17,17,17,17,17,17,17,17,17,18,3,3,3,16,17,18,6,6,
6,6,24,25,25,25,25,25,25,25,25,25,26,2,2,24,25,25,25,25,25,25,25,25,25,25,25,26,2,2,2,24,25,25,25,25,25,25,25,25,25,25,25,25,25,25,25,25,25,25,25,26,3,3,3,24,25,26,6,6,
6,6,2,2,2,2,2,2,2,2,2,2,2,2,2,2,2,2,2,2,2,2,2,2,2,2,2,2,2,2,2,2,2,2,2,2,2,2,2,2,2,2,2,2,2,2,2,2,2,2,2,2,2,2,2,2,2,2,6,6,
6,6,2,2,2,2,2,2,2,2,2,2,2,2,2,2,2,2,2,2,2,2,2,2,2,2,2,2,2,2,2,2,2,2,2,2,2,2,2,2,2,2,2,2,2,2,2,2,2,2,2,2,2,2,2,2,2,2,6,6,
6,6,2,2,2,2,2,2,2,2,2,2,2,2,2,2,2,2,2,2,2,2,2,2,2,2,2,2,2,2,2,2,2,2,2,2,2,2,2,2,2,2,2,2,2,2,2,2,2,2,2,2,2,2,2,2,2,2,6,6,
6,6,2,2,2,2,2,2,2,2,2,2,2,2,2,2,2,2,2,2,2,2,2,2,2,2,2,2,2,2,2,2,2,2,2,2,2,2,2,2,2,2,2,2,2,2,2,2,2,2,2,2,2,2,2,2,2,2,6,6,
6,6,2,2,2,2,2,2,2,2,2,2,2,2,2,2,2,2,2,2,2,2,2,2,2,2,2,2,2,2,2,2,2,2,2,2,2,2,2,2,2,2,2,2,2,2,2,2,2,2,2,2,2,2,2,2,2,2,6,6,
6,6,2,2,2,2,2,2,2,2,2,2,2,2,2,2,2,2,2,2,2,2,2,2,2,2,2,2,2,2,2,2,2,2,2,2,2,2,2,2,2,2,2,2,2,2,2,2,2,2,2,2,2,2,2,2,2,2,6,6,
6,6,2,2,2,2,2,2,2,2,2,2,2,2,2,2,2,2,2,2,2,2,2,2,2,2,2,2,2,2,2,2,2,2,2,2,2,2,2,2,2,2,2,2,2,2,2,2,2,2,2,2,2,2,2,2,2,2,6,6,
6,6,6,6,6,6,6,6,6,6,6,6,6,2,2,6,6,6,6,6,6,6,6,6,6,6,6,6,2,2,2,6,6,6,6,6,6,2,2,2,2,2,2,2,2,2,6,6,6,6,6,6,3,3,3,6,6,6,6,6,
6,6,6,6,6,6,6,6,6,6,6,6,6,2,2,6,6,6,6,6,6,6,6,6,6,6,6,6,2,2,2,6,6,6,6,6,6,2,2,2,2,2,2,2,2,2,6,6,6,6,6,6,3,3,3,6,6,6,6,6,
6,6,8,9,9,9,9,9,9,10,6,6,10,2,2,8,9,9,9,10,6,6,8,9,9,9,9,10,2,2,2,8,9,10,6,6,10,2,2,2,2,2,2,2,2,2,8,6,6,8,9,10,3,3,3,8,9,10,6,6,
6,6,16,17,17,17,17,17,17,18,6,6,18,2,2,16,17,17,17,18,6,6,16,17,17,17,17,18,2,2,2,16,17,18,6,6,18,2,2,2,2,2,2,2,2,2,16,6,6,16,17,18,3,3,3,16,17,18,6,6,
6,6,24,25,25,25,25,25,25,26,6,6,26,2,2,24,25,25,25,26,6,6,24,25,25,25,25,26,2,2,2,24,25,26,6,6,26,2,2,2,2,2,2,2,2,2,24,6,6,24,25,26,3,3,3,24,25,26,6,6,
6,6,3,3,3,3,3,3,3,3,6,6,2,2,2,2,2,2,2,2,6,6,2,2,2,2,2,2,2,2,2,2,2,2,6,6,2,2,2,2,2,2,2,2,2,2,2,6,6,3,3,3,3,3,3,3,3,3,6,6,
6,6,3,3,3,3,3,3,3,3,6,6,2,2,2,2,2,2,2,2,6,6,2,2,2,2,2,2,2,2,2,2,2,2,6,6,2,2,2,2,2,2,2,2,2,2,2,6,6,3,3,3,3,3,3,3,3,3,6,6,
6,6,3,3,3,3,3,3,3,3,6,6,2,2,2,2,2,2,2,2,6,6,2,5,5,5,2,2,7,7,7,7,2,2,6,6,2,2,2,2,2,2,2,2,2,2,2,6,6,3,3,3,3,3,3,3,3,3,6,6,
6,6,3,3,3,3,3,3,3,3,8,10,2,2,2,2,2,2,2,2,6,6,2,5,5,5,2,2,7,7,7,7,2,2,6,6,2,2,2,2,2,2,2,2,2,2,2,6,6,3,3,3,3,3,3,3,3,3,6,6,
6,6,3,3,3,3,3,3,3,3,16,18,2,2,2,2,2,2,2,2,6,6,2,5,5,5,2,2,7,7,7,7,2,2,6,6,2,2,2,2,2,2,2,2,2,2,2,6,6,3,3,3,3,3,3,3,3,3,6,6,
6,6,3,3,3,3,3,3,3,3,24,26,2,2,2,2,2,2,2,2,6,6,2,5,5,5,2,2,7,7,7,7,2,2,6,6,2,2,2,2,2,2,2,2,2,2,2,6,6,3,3,3,3,3,3,3,3,3,6,6,
6,6,3,3,3,3,3,3,3,3,3,3,2,2,2,2,2,2,2,2,6,6,2,5,5,5,2,2,7,7,7,7,2,2,6,6,2,2,2,2,2,2,2,2,2,2,2,6,6,3,3,3,3,3,3,3,3,3,6,6,
6,6,3,3,3,3,3,3,3,3,3,3,2,2,2,2,2,2,2,2,6,6,2,2,2,2,2,2,2,2,2,2,2,2,6,6,2,2,2,2,2,2,2,2,2,2,2,6,6,3,3,3,3,3,3,3,3,3,6,6,
6,6,3,3,3,3,3,3,3,3,3,3,2,2,2,2,2,2,2,2,6,6,2,2,2,2,2,2,2,2,2,2,2,2,6,6,2,2,2,2,2,2,2,2,2,2,2,6,6,3,3,3,3,3,3,3,3,3,6,6,
6,6,6,6,6,6,6,6,6,6,6,6,6,6,6,6,6,6,6,6,6,6,6,6,6,6,6,6,6,6,6,6,6,6,6,6,6,2,2,2,2,2,2,2,2,2,6,6,6,6,6,6,6,6,6,6,6,6,6,6,
6,6,6,6,6,6,6,6,6,6,6,6,6,6,6,6,6,6,6,6,6,6,6,6,6,6,6,6,6,6,6,6,6,6,6,6,6,2,2,2,2,2,2,2,2,2,6,6,6,6,6,6,6,6,6,6,6,6,6,6,

0,0,0,0,0,0,0,0,0,0,0,0,0,0,0,0,0,0,0,0,0,0,0,0,0,0,0,0,0,0,0,0,0,0,0,0,0,0,0,0,0,0,0,0,0,0,0,0,0,0,0,0,0,0,0,0,0,0,0,0,
0,0,0,0,0,0,0,0,0,0,0,0,0,0,0,0,0,0,0,0,0,0,0,0,0,0,0,0,0,0,0,0,0,0,0,0,0,0,0,0,0,0,0,0,0,0,0,0,0,0,0,0,0,0,0,0,0,0,0,0,
0,0,0,0,0,0,0,0,0,0,0,0,0,0,0,0,0,0,0,0,0,0,0,0,0,0,0,0,0,0,0,0,0,0,0,0,0,0,0,0,0,0,0,0,0,0,0,0,0,0,0,0,0,0,0,0,0,0,0,0,
0,0,63,0,0,0,0,0,0,0,0,0,63,0,0,0,0,0,0,0,0,106,63,0,0,63,0,0,0,0,0,106,0,0,63,0,0,0,0,0,0,0,0,0,0,0,63,0,0,63,106,0,0,0,0,0,0,63,0,0,
0,0,71,0,0,0,0,0,0,0,0,0,71,0,0,0,0,0,0,0,0,0,71,0,0,71,0,0,0,0,0,0,0,0,71,0,0,0,0,0,0,0,0,0,0,0,71,0,0,71,0,0,0,0,0,0,0,71,0,0,
0,0,79,0,0,0,0,0,0,0,0,0,79,0,0,0,0,0,0,0,0,0,79,0,0,79,0,0,0,0,0,0,0,0,79,0,0,0,0,0,0,0,0,0,0,0,79,0,0,79,0,0,0,0,0,0,0,79,0,0,
0,0,0,0,0,46,0,0,0,0,0,0,0,0,0,0,0,0,0,0,0,0,0,0,0,0,0,0,0,0,0,0,0,0,0,0,0,0,0,0,0,37,0,37,0,37,0,0,0,0,37,0,37,0,37,0,0,0,0,0,
0,0,0,0,0,46,0,0,0,0,0,0,0,0,92,0,92,0,92,0,92,0,0,0,0,0,0,0,0,0,0,0,0,0,0,0,0,0,0,0,0,0,0,0,102,0,0,0,0,0,0,0,0,0,0,0,0,0,0,0,
0,0,0,38,38,0,0,0,0,0,0,0,0,0,38,0,38,0,38,0,38,0,0,0,0,0,0,0,0,0,0,0,0,0,0,0,0,0,0,0,45,0,102,0,0,0,0,0,0,0,0,0,0,0,0,46,0,0,0,0,
0,0,0,0,0,0,0,0,0,93,0,0,0,0,0,0,0,0,0,0,0,0,86,0,0,0,0,0,0,0,0,0,0,0,0,0,0,0,0,0,0,0,0,0,0,0,0,0,0,0,0,0,0,0,0,0,0,0,0,0,
0,0,0,0,0,0,0,0,118,110,0,0,0,0,0,0,0,0,0,0,0,84,85,0,0,0,0,0,0,0,0,0,0,0,0,0,0,0,0,0,0,38,0,38,0,38,0,0,0,0,38,0,38,0,38,0,0,0,0,0,
0,0,0,0,0,0,0,118,110,102,0,0,0,0,0,0,0,0,0,0,84,85,86,0,0,0,0,0,0,0,0,0,0,0,0,0,0,0,0,0,0,0,0,0,0,0,0,0,0,0,0,0,0,0,0,0,0,87,0,0,
0,0,0,0,0,0,0,0,0,0,0,0,0,0,0,0,0,0,0,0,0,0,0,0,0,0,0,0,0,0,0,0,0,0,0,0,0,0,0,0,0,0,0,0,0,0,0,0,0,0,0,0,0,0,0,0,0,0,0,0,
0,0,0,0,0,0,0,0,0,0,0,0,0,0,0,0,0,0,0,0,0,0,0,0,0,0,0,0,0,0,0,0,0,0,0,0,0,0,0,0,0,0,0,0,0,0,0,0,0,0,0,0,0,0,0,0,0,0,0,0,
0,0,0,0,0,0,0,51,0,0,51,0,0,0,0,0,0,51,0,0,51,0,0,51,0,0,51,0,0,0,0,0,51,0,0,51,0,0,0,0,0,0,0,0,0,0,0,51,0,0,51,0,0,0,0,0,0,0,0,0,
0,0,0,0,0,0,0,59,0,0,59,0,63,0,0,63,0,59,0,0,59,0,0,59,0,0,59,63,0,0,0,63,59,0,0,59,0,0,0,108,109,0,108,109,0,0,0,59,0,0,59,63,0,0,0,106,0,63,0,0,
0,0,115,0,115,0,0,0,0,0,0,0,71,0,0,71,0,0,0,0,0,0,0,0,0,0,0,71,0,0,0,71,0,0,0,0,0,115,0,0,0,0,0,0,0,115,0,0,58,0,0,71,0,0,0,0,0,71,0,0,
0,0,123,0,123,0,0,0,0,0,0,0,79,0,0,79,0,0,0,0,0,0,0,0,0,0,0,79,0,0,0,79,0,0,0,0,0,123,0,0,0,0,0,0,0,123,0,0,66,0,0,79,0,0,0,0,0,79,0,0,
0,0,0,0,0,0,0,0,0,0,0,0,7,7,7,7,0,0,0,0,0,0,0,0,0,0,0,7,7,7,7,7,0,0,0,0,0,0,7,7,7,7,7,7,7,0,0,0,74,0,0,7,7,7,7,7,0,0,0,0,
0,0,0,0,7,7,7,7,7,7,7,7,7,7,7,7,7,7,7,7,7,7,7,7,7,7,7,7,7,7,7,7,7,7,7,7,7,7,7,7,7,7,7,7,7,7,7,7,7,7,7,7,7,7,7,7,7,0,0,0,
0,0,0,0,7,7,7,7,7,7,7,7,7,7,7,7,7,7,7,7,7,7,7,7,7,7,7,7,7,7,7,7,7,7,7,7,7,7,7,7,7,7,7,7,7,7,7,7,7,7,7,7,7,7,7,7,7,0,0,0,
0,0,0,0,7,7,7,7,7,7,7,7,7,7,7,7,7,7,7,7,7,7,7,7,7,7,7,7,7,7,7,7,7,7,7,7,7,7,7,7,7,7,7,7,7,7,7,7,7,7,7,7,7,7,7,7,7,0,0,0,
0,0,0,0,0,0,0,0,0,0,0,0,7,7,7,7,0,0,0,0,0,0,0,0,0,0,0,7,7,7,7,7,0,0,0,0,0,0,7,7,7,7,7,7,7,0,0,0,0,0,0,7,7,7,7,7,0,0,0,0,
0,0,115,0,115,0,0,0,0,0,0,0,115,0,0,115,0,0,0,0,0,0,0,0,0,0,0,0,0,0,0,0,0,0,0,0,0,0,0,7,7,7,7,7,0,0,0,0,0,0,0,0,0,0,0,0,0,0,0,0,
0,0,0,0,0,0,0,0,0,0,0,0,0,0,0,0,0,0,0,0,0,0,0,0,0,0,0,0,0,0,0,0,0,0,0,0,0,0,0,7,7,7,7,7,0,0,0,0,0,0,0,0,0,0,0,0,0,0,0,0,
0,0,0,0,0,0,0,0,0,0,0,0,0,0,0,0,0,0,0,0,0,0,0,0,0,0,0,0,0,0,0,0,0,0,0,0,0,39,0,7,7,7,7,7,0,39,0,0,0,0,0,0,0,0,0,0,0,0,0,0,
0,0,0,0,0,0,0,0,0,0,0,0,0,0,0,0,0,0,0,0,0,0,0,0,0,0,0,0,0,0,0,0,0,0,0,0,0,47,0,7,7,7,7,7,0,47,0,0,0,0,0,0,0,0,0,0,0,0,0,0,
0,0,87,124,0,125,0,117,0,63,0,0,106,0,0,106,0,0,0,63,0,0,87,0,0,0,0,63,0,0,0,106,0,63,0,0,63,55,0,7,7,7,7,7,0,55,63,0,0,87,0,63,0,0,0,106,0,63,0,0,
0,0,95,0,0,0,0,0,0,71,0,0,0,0,0,0,0,0,0,71,0,0,95,0,0,0,0,71,0,0,0,0,0,71,0,0,71,0,0,7,7,7,7,7,0,0,71,0,0,95,0,71,0,0,0,0,0,71,0,0,
0,0,103,0,0,0,0,0,0,79,0,0,0,0,0,0,0,0,0,79,0,0,103,0,0,0,0,79,0,0,0,0,0,79,0,0,79,0,0,7,7,7,7,7,0,0,79,0,0,103,0,79,0,0,0,0,0,79,0,0,
0,0,0,0,0,37,0,0,0,0,0,0,0,0,0,0,0,37,0,0,0,0,0,0,37,0,0,0,0,0,0,0,0,0,0,0,0,0,7,7,7,7,7,7,7,0,0,0,0,0,0,0,0,0,0,0,0,0,0,0,
0,0,0,0,5,5,5,0,0,0,0,0,0,0,0,0,5,5,5,0,0,0,0,0,0,0,0,0,0,0,0,0,0,0,0,0,115,0,7,7,7,7,7,7,7,0,115,0,0,0,0,0,37,0,37,0,0,0,0,0,
0,0,0,45,5,5,5,46,0,0,0,0,0,0,0,45,5,5,5,0,0,0,0,0,102,0,46,0,0,0,0,0,0,0,0,0,123,0,7,7,7,7,7,7,7,0,123,0,0,0,0,5,5,5,5,0,0,0,0,0,
0,0,0,0,5,5,5,0,0,0,0,0,0,0,0,0,5,5,5,0,0,0,0,0,0,0,0,0,0,0,0,0,0,0,0,0,0,0,7,7,7,7,7,7,7,0,0,0,0,0,45,5,5,5,5,46,0,0,0,0,
0,0,0,0,0,38,0,0,0,0,0,0,0,0,0,45,5,5,5,0,0,0,0,101,0,0,46,0,0,0,0,0,0,0,0,0,0,0,7,7,7,7,7,7,7,0,0,0,0,0,0,5,5,5,5,0,0,0,0,0,
0,0,0,0,0,0,0,0,0,0,0,0,0,0,0,0,5,5,5,0,0,0,0,0,0,0,0,0,0,0,0,0,0,0,0,0,115,0,7,7,7,7,7,7,7,0,115,0,0,0,0,38,0,38,0,0,0,0,0,0,
0,0,0,0,0,0,0,0,0,0,0,0,0,0,0,0,0,38,0,0,0,0,0,0,38,0,0,0,0,0,0,0,0,0,0,0,123,0,7,7,7,7,7,7,7,0,123,0,0,0,0,0,0,0,0,0,0,0,0,0,
0,0,0,0,0,0,0,0,0,0,0,0,0,0,0,0,0,0,0,0,0,0,0,0,0,0,0,0,0,0,0,0,0,0,0,0,0,0,0,7,7,7,7,7,0,0,0,0,0,0,0,0,0,0,0,0,0,0,0,0,
0,0,0,0,0,0,0,0,0,0,0,0,0,0,0,0,0,0,0,0,0,0,0,0,0,0,0,0,0,0,0,0,0,0,0,0,0,0,0,7,7,7,7,7,0,0,0,0,0,0,0,0,0,0,0,0,0,0,0,0,
0,0,0,0,0,0,0,0,0,0,0,0,0,0,0,0,0,0,0,0,0,0,0,0,0,0,0,0,0,0,0,0,0,0,0,0,0,0,0,7,7,7,7,7,0,0,0,0,0,0,0,0,0,0,0,0,0,0,0,0,

